NO ./texture/eagle.xpm
SO ./texture/wood.xpm
WE ./texture/wood.xpm
EA ./texture/wood.xpm


F 123,123,2
C 225,30,0

11111111111111111111
10W00000001100000001
101100000111000000011111
100100000000000000000001
111111111011000001110011111111111
100000000011000001110111111111111
11110111111111011100000010001
11110111111111011101010010001
11000000110101011100000010001
10000000000000001100000010001
1000000000000001101010010001
110000011101010111110111100111
11110111 1110101 101111010001
11111111 1111111 111111111111
