NO       ./no.xpm
SO ./so.xpm
WE ./we.xpm
EA ./ea.xpm


F 123,123,2
C 225,30,0

		1111111111111111111
		10000000001100000001
		101100000111000000011111
		1001000000000000000000001
111111111011000001110000000000001
100000000011000001110111111111111
11110111111111011100000010001
11110111111111011101010010001
11000000110101011100000010001
10000000000000001100000010001
1000000000000001101010010001
11000001110101011111011110N0111
111111111111111111111111111
