NO ./texture/eagle.xpm
SO ./texture/purplestone.xpm
WE      ./texture/redbrick.xpm
EA ./texture/colorstone.xpm


F   30,100,120
C   110,    10,50

	111111111111111111111111
1111100000000011000000011111
1011000001110111000000001
1001000000000000000000001
100000111111111111111111111111111111111111
10000000001100000111011111111111111
1111001110110000011100000000000001
11110011111111011100000010001111111

11110011111111011101010010001
11000000110101011100000010001
10000W0000000001100000010001
10000000000000000001001000001
110000000001010111110111100011
11110111111010110111101000111
1111111111111111111111111111
