NO ./texture/eagle.xpm
SO ./texture/purplestone.xpm
WE      ./texture/redbrick.xpm
EA ./texture/colorstone.xpm

F   30,100,120

C   110,    10,50

		111111111111111111111111
111111111000000000110000001111
10000011101110000000001111
1100100000000000000000001
100000111111111111111111111111111111111111
110000000001100000111011111111111111
111001110110000011100000000000001
11110011111111011100000010001111111
11110011111111011101010010001
11000000110101011100000010001
10000000000000001100000010001
10000N00000000000001001000001
110000000001010111110111100011
11110111111010110111101000111
11111111111111111111111111111



