NO ./texture/eagle.xpm
SO ./texture/purplestone.xpm
WE ./texture/redbrick.xpm
EA ./texture/colorstone.xpm

F 30,100,120

C 110,10,50

	111111111111111111111111
	111000000000110000001111
	110001110111000000000111
111110000000000000000001111
1W0000111111111111111111111111111111
110000000001100000111011111111111111111111
111001110110000011100000000000000000000001
11110011111111011100000010001111111111111111
11110011111111011101010010001
11000000110101011100000010001
10000000000000001100000010001
10000000000000000010010000011
110000000001010111110111100011
1111111111010110111101000111
1111111111111111111111111111
